MMMMMMMMMMMMMMMMMMMMMMMMMMMMMMMMMMMMMMMMM
MMMMMMMMMMMMMMMMMMMMMMMMMMMMMMMMMMMMMMMMM
MMMMMMMMMMMMMMMMMMMMMMMMMMMMMMMMMMMMMMMMM
MMM..........M....RR.........R....R...MMM
MMM.RRR.R.R..B..R....RRR.R.R.R..R...F.MMM
MMM.....R.R..M..R.RR.....R.R.R..R.R...MMM
MMM.RRMMMMMMMMMMMMMMCMMMMMMMMMMMMMMMMMMMM
MMM.R.MMMMMMMMMMMMMMCMMMMMMMMMMMMMMMMMMMM
MMM.R..R......M.....RR..R.....M....R..MMM
MMM.R..R.RRR..B..R..RR..R.RRR.B..R.RR.MMM
MMM........R..M..R..........R.M..R....MMM
MMMCMMMMMMMMMMMMMMMMMMMMMMMMMMMMMMM.R.MMM
MMMCMMMMMMMMMMMMMMMMMMMMMMMMMMMMMMM...MMM
MMMCMMMMMMMMMMMMMMMMMMMMMMMMMMMMMMMMBMMMM
MMMCMMMMMMMMMMMMMMMMMMMMMMMMMMMMMMM...MMM
MMMCMMMMMMMMMMMMMMMMMMMMMMMMMMMMMMM...MMM
MMM....R.M..R.....R.....R.M..R....R.R.MMM
MMM....R.B.RR..R..R.R...R.B.RR.R..R.R.MMM
MMMRR....M.....R.....R....M....R......MMM
MMM...MMMMMMMMMMMMMMMMMMMMMMMMMMMCMMMMMMM
MMMRR.MMMMMMMMMMMMMMMMMMMMMMMMMMMCMMMMMMM
MMM...MMMMMMMMMMMMMMMMMMMMMMMMMMMCMMMMMMM
MMM.R.MMMMMMMMMMMMMMMMMMMMMMMMMMMCMMMMMMM
MMM.R....M.....R.....R....M....R......MMM
MMM.RR.R.B..RR.RRR.RRRR.R.B..R.RRR....MMM
MMM....R.M.......R.R....R.M......R.RR.MMM
MMMMMMMMMMMMMMMMMMMMMCMMMMMMMMMMMMM...MMM
MMMMMMMMMMMMMMMMMMMMMCMMMMMMMMMMMMMRR.MMM
MMMMMMMMMMMMMMMMMMMMMCMMMMMMMMMMMMM...MMM
MMMMMMMMMMMMMMMMMMMMMCMMMMMMMMMMMMMRR.MMM
MMM....R....R....M......R....R...M..R.MMM
MMMRRR.R.R..R.RR.B..RRR.R.R..RRR.B..R.MMM
MMM......R.......M..R.....R......M....MMM
MMM.RRMMMMMMMMMMMMMMCMMMMMMMMMMMMMMMMMMMM
MMM...MMMMMMMMMMMMMMCMMMMMMMMMMMMMMMMMMMM
MMM.RRMMMMMMMMMMMMMMCMMMMMMMMMMMMMMMMMMMM
MMM..R......R...R..M..R......R..R.....MMM
MMM..RRR.R..R..RRR....RRR.R..R.RRR..I.MMM
MMM......R.........M......R...........MMM
MMMMMMMMMMMMMMMMMMMMMMMMMMMMMMMMMMMMMMMMM
MMMMMMMMMMMMMMMMMMMMMMMMMMMMMMMMMMMMMMMMM
MMMMMMMMMMMMMMMMMMMMMMMMMMMMMMMMMMMMMMMMM